        ######## 
        #     P# 
        # X#X ## 
        # X  X#  
        ##X X #  
######### X # ###
#OOOO  ## X  X  #
##OOO    X  X   #
#OOOO  ##########
########         
