        #####    
        #   #####
        # #X##  #
        #     X #
######### ###   #
#OOOO  ## X  X###
#OOOO    X XX ## 
#OOOO  ##X  X P# 
#########  X  ## 
        # X X  # 
        ### ## # 
          #    # 
          ###### 
