       ##### 
 #######   ##
## # P## XX #
#    X      #
#  X  ###   #
### #####X###
# X  ### OO# 
# X X X OOO# 
#    ###OOO# 
# XX # #OOO# 
#  ### ##### 
####         
