##########################
#              #         #
#              #         #
#              ####   ####
#                        #
#                        #
#                        #
#            P           #
#                        #
#             X          #
#                        #
#                O       #
#                        #
##########################
